.......!.p
......x!..
..!!!!!!..
.......#..
..........