...........!.......p
..........x!........
x.......!!!!........
.......!...#........
...........#........
....................