..!x....!...!.......
........!...........
...!......!.........
!........#.........#
....................
..............x...!.
....!.....#.x.......